##############################
#...k................s.......#
#.#.######################.#.# 
........................k.....
#.#.###.###.######.###.###.#.#
#.#.#.........##.........#.#.#
#.#.#.#######.##.#######.#.#.#
#.#...#..s.............#...#.#
#.#.#...###.######.###...#.#.#
#.#.###.###........###.###.#.#
#.#.###.#...#*####...#.###.#.#
#.#.#...###.######.###...#.#.#
#.#...#.k.........s....#.....#
#.#.#.#######.##.#######.#.#.#
#.#.#....s....##.........#.#.#
#.#.###.###.######.###.###.#.#
........k.....................
#.#.######################.#.#
#.s....................k.....#
##############################