##############################
#............................#
#.#.######################.#.# 
..............................
#.#.###.###.######.###.###.#.#
#.#.#.........##.........#.#.#
#.#.#.#######.##.#######.#.#.#
#.#...#................#...#.#
#.#.#...###.######.###...#.#.#
#.#.###.###........###.###.#.#
#.#.###.#...#*####...#.###.#.#
#.#.#...###.######.###...#.#.#
#.#...#................#.....#
#.#.#.#######.##.#######.#.#.#
#.#.#.........##.........#.#.#
#.#.###.###.######.###.###.#.#
..............................
#.#.######################.#.#
#............................#
##############################