#######.############.#########
#......k................##...#
#.#####.######.#####.##.##.###
#.#####.######.#####.##....###
#....##.....##....##.##.######
#.##.##.###.##.##.##.##.######
#.##....###....##....##....###
#.#####.###.#####.#####.##.###
#.#####.###.#####.#####.##.###
#..k.................k..##...#
#.##.######.#.###.##.#####.###
#.##.######...###.##.#####.###
#.##.....##.#.....##.......###
#.######.##.*####.#####.######
#.######.##.*####.#####.######
#.##.....##.#.....##.......###
#.##.######...###.##.#####.###
#.##.######.#.###.##.#####.###
#......k................##...#
#######.############.#########