#######.############.#########
#......k........s.......##.k.#
#.#####.######.#####.##.##.###
#.#####.######.#####.##....###
#....##.....##....##.##.######
#.##.##.###.##.##.##.##.######
#.##....###....##....##....###
#.#####.###.#####.#####.##.###
#.#####.###.#####.#####.##.###
#..k...............k....##...#
#.##.######.#.###.##.#####.###
#.##.######...###.##.#####.###
#.##.....##.#.....##.......###
#.######s##.*####.#####.######
#.######.##.#####.#####.######
#.##.....##.#.....##...s...###
#.##.######...###.##.#####.###
#.##.######.#.###.##.#####.###
#..........k............##...#
#######.############.#########